111111111111
1C00000001P1
10000C000101
1C0000C00E01
111111111111