1111111
1P00001
100E0C1
1C00001
1111111